G************
   *      *
*************
*     *
*     *******
****  *   *
*     S
*     *******
*******     *
      *     *
*******  ****
*        *
*************