****    *****
   *    *
*************
*  *  *
*  *  *******
*  *  *
*  *  *
*  *  S******
*     *     *
*     *     *
*     *  ****
*     *  *
************G
